3 3 2 2
XXX
XXX
XXX
3 3 2 2
XX.
XXX
XXX
17 32 5 9
........XXXXXXXX................
........XXXXXXXX................
........XXXXXXXX................
........XXXXXXXXX...............
........XXXXXXXXXXXXXXX.........
........XXXXXXXXXXXXXXXXXXXX....
........XXXXXXXXXXXXXXXXXXXXX...
XXXXXXXXXXXXXXXXXXXXXXXXXXXXXX..
..XXXXXXXXXXXXXXXXXXXXXXXXXXXXX.
....XXXXXXXXXXXXXXXXXXXXXXXXXXX.
......XXXXXXXXXXXXXXXXXXXXXXXXX.
........XX..XXXXXXXXXXXXXXXXX...
.............XXXXXXXXXXXXXX.....
...............XXXXXXXXX........
................XXXXXXX.........
.................XXXXX..........
....................XXX.........
17 32 5 9
........XXXXXXXX................
........XXXXXXXX................
........XXXXXXXX................
........XXXXXXXXX...............
........XXXXXXXXXXXXXXX.........
........XXXXXXXXXXXXXXXXXXXX....
........XXXXXXXXXXXXXXXXXXXXX...
XXXXXXXXXXXXXXXXXXXXXXXXXXXXXX..
..XXXXXXXXXXXXXXXXXXXXXXXXXXXXX.
....XXXXXXXXXXXXXXXXXXXXXXXXXXX.
......XXXXXXXXXXXXXXXXXXXXXXXXX.
........XX..XXXXXXXXXXXXXXXXX...
.............XXXXXXXXXXXXXX.....
...............XXXXXXXXX........
................XXXXXXX.........
.................XXXXX..........
....................XXX.........
17 32 5 9
........XXXXXXXX................
........XXXXXXXX................
........XXXXXXXX................
........XXXXXXXXX...............
........XXXXXXXXXXXXXXX.........
........XXXXXXXXXXXXXXXXXXXX....
........XXXXXXXXXXXXXXXXXXXXX...
XXXXXXXXXXXXXXXXXXXXXXXXXXXXXX..
..XXXXXXXXXXXXXXXXXXXXXXXXXXXXX.
....XXXXXXXXXXXXXXXXXXXXXXXXXXX.
......XXXXXXXXXXXXXXXXXXXXXXXXX.
........XX..XXXXXXXXXXXXXXXXX...
.............XXXXXXXXXXXXXX.....
...............XXXXXXXXX........
................XXXXXXX.........
.................XXXXX..........
....................XXX.........
17 32 5 9
........XXXXXXXX................
........XXXXXXXX................
........XXXXXXXX................
........XXXXXXXXX...............
........XXXXXXXXXXXXXXX.........
........XXXXXXXXXXXXXXXXXXXX....
........XXXXXXXXXXXXXXXXXXXXX...
XXXXXXXXXXXXXXXXXXXXXXXXXXXXXX..
..XXXXXXXXXXXXXXXXXXXXXXXXXXXXX.
....XXXXXXXXXXXXXXXXXXXXXXXXXXX.
......XXXXXXXXXXXXXXXXXXXXXXXXX.
........XX..XXXXXXXXXXXXXXXXX...
.............XXXXXXXXXXXXXX.....
...............XXXXXXXXX........
................XXXXXXX.........
.................XXXXX..........
....................XXX.........
17 32 5 9
........XXXXXXXX................
........XXXXXXXX................
........XXXXXXXX................
........XXXXXXXXX...............
........XXXXXXXXXXXXXXX.........
........XXXXXXXXXXXXXXXXXXXX....
........XXXXXXXXXXXXXXXXXXXXX...
XXXXXXXXXXXXXXXXXXXXXXXXXXXXXX..
..XXXXXXXXXXXXXXXXXXXXXXXXXXXXX.
....XXXXXXXXXXXXXXXXXXXXXXXXXXX.
......XXXXXXXXXXXXXXXXXXXXXXXXX.
........XX..XXXXXXXXXXXXXXXXX...
.............XXXXXXXXXXXXXX.....
...............XXXXXXXXX........
................XXXXXXX.........
.................XXXXX..........
....................XXX.........
17 32 5 9
........XXXXXXXX................
........XXXXXXXX................
........XXXXXXXX................
........XXXXXXXXX...............
........XXXXXXXXXXXXXXX.........
........XXXXXXXXXXXXXXXXXXXX....
........XXXXXXXXXXXXXXXXXXXXX...
XXXXXXXXXXXXXXXXXXXXXXXXXXXXXX..
..XXXXXXXXXXXXXXXXXXXXXXXXXXXXX.
....XXXXXXXXXXXXXXXXXXXXXXXXXXX.
......XXXXXXXXXXXXXXXXXXXXXXXXX.
........XX..XXXXXXXXXXXXXXXXX...
.............XXXXXXXXXXXXXX.....
...............XXXXXXXXX........
................XXXXXXX.........
.................XXXXX..........
....................XXX.........
17 32 5 9
........XXXXXXXX................
........XXXXXXXX................
........XXXXXXXX................
........XXXXXXXXX...............
........XXXXXXXXXXXXXXX.........
........XXXXXXXXXXXXXXXXXXXX....
........XXXXXXXXXXXXXXXXXXXXX...
XXXXXXXXXXXXXXXXXXXXXXXXXXXXXX..
..XXXXXXXXXXXXXXXXXXXXXXXXXXXXX.
....XXXXXXXXXXXXXXXXXXXXXXXXXXX.
......XXXXXXXXXXXXXXXXXXXXXXXXX.
........XX..XXXXXXXXXXXXXXXXX...
.............XXXXXXXXXXXXXX.....
...............XXXXXXXXX........
................XXXXXXX.........
.................XXXXX..........
....................XXX.........
17 32 5 9
........XXXXXXXX................
........XXXXXXXX................
........XXXXXXXX................
........XXXXXXXXX...............
........XXXXXXXXXXXXXXX.........
........XXXXXXXXXXXXXXXXXXXX....
........XXXXXXXXXXXXXXXXXXXXX...
XXXXXXXXXXXXXXXXXXXXXXXXXXXXXX..
..XXXXXXXXXXXXXXXXXXXXXXXXXXXXX.
....XXXXXXXXXXXXXXXXXXXXXXXXXXX.
......XXXXXXXXXXXXXXXXXXXXXXXXX.
........XX..XXXXXXXXXXXXXXXXX...
.............XXXXXXXXXXXXXX.....
...............XXXXXXXXX........
................XXXXXXX.........
.................XXXXX..........
....................XXX.........
17 32 5 9
........XXXXXXXX................
........XXXXXXXX................
........XXXXXXXX................
........XXXXXXXXX...............
........XXXXXXXXXXXXXXX.........
........XXXXXXXXXXXXXXXXXXXX....
........XXXXXXXXXXXXXXXXXXXXX...
XXXXXXXXXXXXXXXXXXXXXXXXXXXXXX..
..XXXXXXXXXXXXXXXXXXXXXXXXXXXXX.
....XXXXXXXXXXXXXXXXXXXXXXXXXXX.
......XXXXXXXXXXXXXXXXXXXXXXXXX.
........XX..XXXXXXXXXXXXXXXXX...
.............XXXXXXXXXXXXXX.....
...............XXXXXXXXX........
................XXXXXXX.........
.................XXXXX..........
....................XXX.........
